111111111111111111111111
1E0000000000000000000001
100000000000000000000001
1C0P00000000000000000001
100000000000000000000001
100000000000000000000001
1C0000000000000000000001
100000000000000000000001
100000000000000000000001
100000000000000000000001
1C0000000000000000000001
100000000000000000000001
100000000000000000000001
1C0000000000000000000001
1C0000000000000000000001
100000000000000000000001
100000000000000000000001
111111111111111111111111
