11111111111111111111111111111111111
1P000000000000000000000000000000001
1000000011C0000011111111111C0CCCC01
100000011C00000011111111111C0CCCC01
10000011C000000011C0000011C00CCCC01
1000011C0000000011C000011C000CCCC01
100011C00000000000000011C0000CCCC01
10011C00000000000000011C00000CCCC01
1011CCCCCCCC0000000011C000000CCCC01
10111111111C000000011C0000000CCCC01
10111111111C00000011C000CCCC0000001
10000000011C0000011CCCCCC11C0000001
10000000011C000011111111111C00CC001
10000000011C000111111111111C00CC001
1E000000000000000000000000000000001
11111111111111111111111111111111111 