11111
1P0E1
10001 
10C01
11111 