11111
1P0E1
10G11
10C01
11111 