11111
1E001
11101
1C0P1
11111 