11111
100E1
10001
10CP1
11111 