11111111
1CEP0CC1
10100C01
1CCC0C01
11111111 