11111111
1C0P0CE1
1111GC11
1CCCGC01
1CCCCCG1
11111111 