11111111
10000PE1
11100001
1C0000C1
11111111 