11111111
1CEP0CC1
1010GC01
1CCCGC01
1CCCCCG1
11111111 