11111111
100P00E1
11110011
1000C001
100CGC01
1000C001
11111111 