1111111111111111111111
1E00000000000000000001
1110000000000000000001
1C0P000000000000000001
1111111011111111111111
1110000000000000000001
1C00000000000000000001
1111111011111111111111
1111111011111111111111
1110000000000000000001
1C00000000000000000001
1111111011111111111111
1111111011111111111111
1110000000000000000001
1C00000000000000000001
1111111001111111111111
1111111011111111111111
1110000000000000000001
1C00000000000000000001
1111111111111111111111 