111111111111111111111111
1CCCCCCCCCCCCCCCCCCCCCC1
1C00000000000000000000C1
1C00P00000000000000E00C1
1C00000000000000000000C1
1CCCCCCCCCCCCCCCCCCCCCC1
111111111111111111111111
